4 4 4 4 4 4 4 4 4 4 4 4 4 4 4 4 7 7 7 7 7 7 7 7 
4 0 1 0 0 0 0 0 0 0 0 0 0 0 0 0 7 0 0 0 0 0 0 7
4 0 0 0 0 0 0 0 0 0 0 0 0 0 0 0 0 0 0 0 0 0 0 7 
4 1 2 0 1 0 0 0 0 0 0 0 0 0 0 0 0 0 0 0 0 0 0 7 
4 0 3 0 0 1 0 0 0 0 0 0 0 0 0 0 7 0 0 0 0 0 0 7 
4 0 4 0 1 0 0 5 5 5 5 5 5 5 5 5 7 7 0 7 7 7 7 7 
4 0 5 0 0 1 0 5 0 5 0 5 0 5 0 5 7 0 0 0 7 7 7 1 
4 0 6 0 1 0 0 5 0 0 0 0 0 0 0 5 7 0 0 0 0 0 0 8 
4 0 7 0 0 0 0 0 0 0 0 0 0 0 0 0 0 0 0 0 7 7 7 1 
4 0 8 0 0 0 0 5 0 0 0 0 0 0 0 5 7 0 0 0 0 0 0 8 
4 0 0 0 0 0 0 5 0 0 0 0 0 0 0 5 7 0 0 0 7 7 7 1 
4 0 0 0 0 0 0 5 5 5 5 0 5 5 5 5 7 7 7 7 7 7 7 1 
6 6 6 6 6 6 6 6 6 6 6 0 6 6 6 6 6 6 6 6 6 6 6 6 
8 0 0 0 0 0 0 0 0 0 0 0 0 0 0 0 0 0 0 0 0 0 0 4 
6 6 6 6 6 6 0 6 6 6 6 0 6 6 6 6 6 6 6 6 6 6 6 6 
4 4 4 4 4 4 0 4 4 4 6 0 6 2 2 2 2 2 2 2 3 3 3 3 
4 0 0 0 0 0 0 0 0 4 6 0 6 2 0 0 0 0 0 2 0 0 0 2 
4 0 0 0 0 0 0 0 0 0 0 0 6 2 0 0 5 0 0 2 0 0 0 2 
4 0 0 0 0 0 0 0 0 4 6 0 6 2 0 0 0 0 0 2 2 0 2 2 
4 0 6 0 6 0 0 0 0 4 6 0 0 0 0 0 5 0 0 0 0 0 0 2 
4 0 0 5 0 0 0 0 0 4 6 0 6 2 0 0 0 0 0 2 2 0 2 2 
4 0 6 0 6 0 0 0 0 4 6 0 6 2 0 0 5 0 0 2 0 0 0 2 
4 0 0 0 0 0 0 0 0 4 6 0 6 2 0 0 0 0 0 2 0 0 0 2 
4 4 4 4 4 4 4 4 4 4 4 1 1 1 2 2 2 2 2 3 3 3 3 3
